xxxxxxxxxx
xx...xFIxx
xx.x...xxx
xxIxxx.xxx
xxWxPB.xxx
xI.Vxx.xxx
xxxxCx.FIx
xI...WWWxx
xx.xxxxIxx
xS.xxxxxxx