CxFF..FF.x
.xF.S.Fx.x
.xF.I.Fx.x
.x....Fx.x
.x..WWFx.x
.I..Wxxx.x
.x..Wxxx.x
.x..Wxxx.x
Ix..Wxxx.x
Vx.IWxxxBP