.........C
.xxxIxxxIx
..IxxxSxxx
.x........
.xxxxx.xxx
WxWWWxFFFI
WxWxWxF...
WxWxWxF...
WxWxWxFFFB
WWWxVFF.xP