CxIxIxxxBP
.x.x.xxxWx
.x.x.xxxWx
.WWWWWWWWx
.xxxxxxxxx
.xVxFFFFFF
.x.xFxxIxF
.x.xFxxxxF
.x.xFFFFFS
....FxxIxx