xxxxxxxxxx
xxxxxxxxxx
xxIxxxxx.x
x.......Ix
xx.xFx...x
xx..C..xxx
xI.x.x..xx
xx.x...xxx
xPBx.x.Ixx
xxxxxxxxxx