xxxxxxxxxx
xWWW...xxx
xWVW...FIx
xWWWFx.xxx
xx.xIx.WIx
xx.xxx.xxx
xx.....xIx
x..xxx..Fx
xC.BPxxISx
xxxxxxxxxx