PBWIxxxxxx
xFFF.x.xxx
xxFx.....x
xxFxxx.xWI
xxIxIx.xVx
xxxx...xxx
xx.......x
xx.xIxxS.x
xC.xxxxxxx
xxxxxxxxxx