xxxxxxxxxx
xC.....WIx
xx.xxx.xVx
xSIxxx.xxx
xxxIxx.xxx
x..F...xxx
xxxIxx.xxx
xxxxxx.xxx
xIWWWI.BPx
xxxxxxxxxx