Pxxxxxxxxx
xPI..x.xxx
xx.x.....x
xxFxxx.xWI
xxIxIx.xxx
xxxx...xxx
xx.......x
xx.xIxxS.x
xC.xxxxxxB