xxxxxxPxxx
xC.....WIx
xx.xxx.xxx
xSIxxx.Bxx
xxxIxx.xxx
x......xxx
x.xFxx.xxx
xVxIxx.xxx
xIxxxI.xxx
xxxxxVxxxx