xxxxxxxxxx
xI.....FIx
x......xVx
x..WWW.xxx
xxWWPB...x
xS.VWW.x.x
xxxxxx.xIx
xS......xx
xIxxxxx.Cx
xxxxxxxxxx