xxxxxxxxxx
xP...x.Ixx
xx.x...xxx
xxIxxx.xxx
xxWxPB.Vxx
xI.Vxx.xxx
xxxxCx.FIx
xS.....Wxx
xx.xxxxIxx
xB.xxxxxxx