xxxxxxxxxx
x......FFx
x......xIx
x..xxx.xxx
xxWxPB...x
xI.Vxx.x.x
xxxxxx.xIx
xS......xx
xIxxxxx.Cx
xxxxxxxxxx