xxxxxxxxxx
xx.....xxx
xV....FFIx
xI.x.x.xxx
xx.xIx.WIx
xs.Vxx.xxx
xx.xxx.xIx
x...xx..xx
xcxBPxxSIx
xxxxxxxxxx