xxxxxxxxxx
xxxxxxxxxx
xxIxxxxx.x
x.......Ix
xx.xFx...x
xx..C..x.x
xI.x.x..Fx
xx.x...x.x
xPBxVx.I.x
xxxxxxxxxx